[0]
\xd4\xd7\xd9\xd9\xd7\xd4
\xdb\x00\x00\x00\x00\xdb
\xdc\x00\x00\x00\x00\xdc
\xdc\x00\x00\x00\x00\xdc
\xdc\x00\x00\x00\x00\xdc
\xdc\x00\x00\x00\x00\xdc
\xdc\x00\x00\x00\x00\xdc
\xdc\x00\x00\x00\x00\xdc
\xdc\x00\x00\x00\x00\xdc
\xdc\x00\x00\x00\x00\xdc
\xdc\x00\x00\x00\x00\xdc
\xdd\x00\x00\x00\x00\xdd
\xd4\xd7\xd9\xd9\xd7\xd4