[1]
\x02\x03\x03\x03\x03\x03\x03\x03\x03\x03\x02\x00\x00\x00\x00\x00\x00\x00\x00\x00\x00\x00\x00\x00\x00\x00\x00\x00\x00\x00\x00\x00
\x04\x00\x00\x00\x00\x00\x00\x00\x00\x00\x04\x00\x46\x3a\x41\x3a\x00\x00\x00\x00\x00\x00\x00\x00\x00\x00\x00\x00\x00\x00\x00\x00
\x04\x00\x00\x00\x00\x00\x00\x00\x00\x00\x04\x05\x06\x06\x06\x06\x06\x06\x06\x06\x00\x00\x00\x00\x00\x00\x00\x00\x00\x00\x00\x00
\x04\x00\x00\x00\x00\x00\x00\x00\x00\x00\x04\x00\x45\x39\x41\x3a\x00\x00\x00\x00\x00\x00\x00\x00\x00\x00\x00\x00\x00\x00\x00\x00
\x04\x00\x00\x00\x00\x00\x00\x00\x00\x00\x04\x05\x06\x06\x06\x06\x06\x06\x06\x06\x00\x00\x00\x00\x00\x00\x00\x00\x00\x00\x00\x00
\x04\x00\x00\x00\x00\x00\x00\x00\x00\x00\x04\x00\x39\x28\x6c\x3f\x00\x00\x00\x00\x00\x00\x00\x00\x00\x00\x00\x00\x00\x00\x00\x00
\x04\x00\x00\x00\x00\x00\x00\x00\x00\x00\x04\x05\x06\x06\x06\x06\x06\x06\x06\x06\x00\x00\x00\x00\x00\x00\x00\x00\x00\x00\x00\x00
\x04\x00\x00\x00\x00\x00\x00\x00\x00\x00\x04\x00\x3d\x39\x44\x3a\x00\x00\x00\x00\x00\x00\x00\x00\x00\x00\x00\x00\x00\x00\x00\x00
\x04\x00\x00\xed\x00\x00\x00\x00\x00\x00\x04\x05\x06\x06\x06\x06\x06\x06\x06\x06\x00\x00\x00\x00\x00\x00\x00\x00\x00\x00\x00\x00
\x04\x00\x00\x00\x00\x00\x00\x00\x00\x00\x04\x00\x00\x00\x00\x00\x00\x00\x00\x00\x00\x00\x00\x00\x00\x00\x00\x00\x00\x00\x00\x00
\x04\x00\x00\xed\x00\x00\x00\x00\x00\x00\x04\x01\x01\x01\x01\x01\x01\x01\x01\x01\x00\x00\x00\x00\x00\x00\x00\x00\x00\x00\x00\x00
\x02\x03\x03\x03\x03\x03\x03\x03\x03\x03\x02\x00\x00\x00\x00\x00\x00\x00\x00\x00\x00\x00\x00\x00\x00\x00\x00\x00\x00\x00\x00\x00
\x00\x07\x08\x09\x94\x4c\x5d\x97\x3d\x3b\x00\x01\x01\x01\x01\x01\x01\x01\x01\x01\x00\x00\x00\x00\x00\x00\x00\x00\x00\x00\x00\x00
\x00\x00\x00\x00\x00\x00\x00\x00\x00\x00\x00\x00\x00\x00\x00\x00\x00\x00\x00\x00\x00\x00\x00\x00\x00\x00\x00\x00\x00\x00\x00\x00
\x00\x00\x00\x00\x00\x00\x00\x00\x00\x00\x00\x00\x00\x00\x00\x00\x00\x00\x00\x00\x00\x00\x00\x00\x00\x00\x00\x00\x00\x00\x00\x00
\x00\x00\x00\x00\x00\x00\x00\x00\x00\x00\x00\x00\x00\x00\x00\x00\x00\x00\x00\x00\x00\x00\x00\x00\x00\x00\x00\x00\x00\x00\x00\x00
\x00\x00\x00\x00\x00\x00\x00\x00\x00\x00\x00\x00\x00\x00\x00\x00\x00\x00\x00\x00\x00\x00\x00\x00\x00\x00\x00\x00\x00\x00\x00\x00
\x00\x00\x00\x00\x00\x00\x00\x00\x00\x00\x00\x00\x00\x00\x00\x00\x00\x00\x00\x00\x00\x00\x00\x00\x00\x00\x00\x00\x00\x00\x00\x00