[1]
\x00\x00\x00\x00\x00\x00\x00\x00\x00\x00\x01\x01\x02\x03\x04\x05\x06\x07\x08\x00\x00\x00\x00\x00\x00\x00\x00\x00\x00\x00\x00\x00
\x00\x00\x00\x00\x00\x00\x00\x00\x00\x00\x09\x0a\x0b\x0c\x0d\x0e\x0f\x10\x11\x12\x00\x00\x00\x00\x00\x00\x00\x00\x00\x00\x00\x00
\x00\x00\x00\x00\x00\x00\x00\x00\x00\x00\x13\x14\x15\x16\x17\x18\x19\x1a\x1b\x1c\x00\x00\x00\x00\x00\x00\x00\x00\x00\x00\x00\x00
\x00\x00\x00\x00\x00\x00\x00\x00\x00\x00\x1d\x1e\x1f\x20\x21\x22\x00\x23\x24\x25\x00\x00\x00\x00\x00\x00\x00\x00\x00\x00\x00\x00
\x00\x00\x00\x00\x00\x00\x00\x00\x00\x00\x26\x27\x28\x29\x2a\x2b\x2c\x2d\x2e\x2f\x00\x00\x00\x00\x00\x00\x00\x00\x00\x00\x00\x00
\x00\x00\x00\x00\x00\x00\x00\x00\x00\x00\x30\x31\x32\x33\x34\x35\x36\x37\x38\x39\x00\x00\x00\x00\x00\x00\x00\x00\x00\x00\x00\x00
\x00\x00\x00\x00\x00\x00\x00\x00\x00\x00\x3a\x3b\x3c\x3d\x3e\x3f\x40\x41\x41\x41\x00\x00\x00\x00\x00\x00\x00\x00\x00\x00\x00\x00
\x00\x00\x00\x00\x00\x00\x00\x00\x00\x00\x42\x43\x44\x45\x46\x47\x48\x49\x4a\x41\x00\x00\x00\x00\x00\x00\x00\x00\x00\x00\x00\x00
\x00\x00\x00\x00\x00\x00\x00\x00\x00\x00\x4b\x4c\x4d\x1e\x4e\x4f\x50\x01\x51\x41\x00\x00\x00\x00\x00\x00\x00\x00\x00\x00\x00\x00
\x00\x00\x00\x00\x00\x00\x00\x00\x00\x00\x52\x53\x54\x55\x56\x57\x58\x01\x59\x41\x00\x00\x00\x00\x00\x00\x00\x00\x00\x00\x00\x00
\x00\x00\x00\x00\x00\x00\x00\x00\x00\x00\x5a\x5b\x5c\x5d\x5e\x5f\x60\x61\x62\x41\x00\x00\x00\x00\x00\x00\x00\x00\x00\x00\x00\x00
\x00\x00\x00\x00\x00\x00\x00\x00\x00\x00\x00\x63\x1e\x64\x41\x41\x65\x66\x67\x41\x00\x00\x00\x00\x00\x00\x00\x00\x00\x00\x00\x00
\x00\x00\x00\x00\x00\x00\x00\x00\x00\x00\x00\x68\x1e\x69\x41\x6a\x6b\x01\x6c\x41\x00\x00\x00\x00\x00\x00\x00\x00\x00\x00\x00\x00
\x00\x00\x00\x00\x00\x00\x00\x00\x00\x00\x00\x6d\x6e\x41\x41\x41\x6f\x70\x71\x41\x00\x00\x00\x00\x00\x00\x00\x00\x00\x00\x00\x00
\x00\x00\x00\x00\x00\x00\x00\x00\x00\x00\x72\x73\x74\x75\x76\x77\x78\x79\x7a\x7b\x00\x00\x00\x00\x00\x00\x00\x00\x00\x00\x00\x00
\x00\x00\x00\x00\x00\x00\x00\x00\x00\x00\x7c\x7d\x7e\x7f\x80\x81\x82\x83\x84\x85\x00\x00\x00\x00\x00\x00\x00\x00\x00\x00\x00\x00
\x00\x00\x00\x00\x00\x00\x00\x00\x00\x00\x86\x87\x88\x89\x8a\x8b\x8c\x8d\x8e\x8f\x00\x00\x00\x00\x00\x00\x00\x00\x00\x00\x00\x00
\x00\x00\x00\x00\x00\x00\x00\x00\x00\x00\x90\x91\x92\x93\x94\x95\x96\x97\x98\x1e\x00\x00\x00\x00\x00\x00\x00\x00\x00\x00\x00\x00
\x00\x00\x00\x00\x00\x00\x00\x00\x00\x00\x00\x00\x00\x00\x00\x00\x00\x00\x00\x00\x00\x00\x00\x00\x00\x00\x00\x00\x00\x00\x00\x00